2222222222222222222222222222222222222222222222222222
2222222222222222222222222222222222222222222222222222
2222222222222222222222222222222222222222222222222222
2221111111111111111111111111111111111111111111111222
2221000000000000000000000000000000000000000000001222
2221000000000000000000000000000000000000000000001222
2221000000000000000000000000000000000000000000001222
2221000000000000000000000000000000000000000000001222
2221000000000000000000000000000000000000000000001222
2221000000000000000000000000000000000000000000001222
2221000000000000000000000000000000000000000000001222
2221000000000000000000000000000000000000000000001222
2221000011111000000000000000000000000001111100001222
2221000000000000000000000000000000000000000000001222
2221000000000000000000000000000000000000000000001222
2221000000000000000000000B00000000000000000000001222
2221000000000000000000111111100000000000000000001222
2221000000000000000000000000000000000000000000001222
2221000000000000000000000000000000000000000000001222
2221000000000000000000000000000000000000000000001222
2221000011111000000000000000000000000001111100001222
2221000000000000000000000000000000000000000000001222
2221000000000000000000000000000000000000000000001222
2221000000000000000000000000000000000000000000001222
2221000000000000000000000000000000000000000000001222
22210P0000000000000000000000000000000000000000001222
2221111111111111111111111111111111111111111111111222
2222222222222222222222222222222222222222222222222222
2222222222222222222222222222222222222222222222222222
2222222222222222222222222222222222222222222222222222
